11111111111111111111111111
1P0000000000000000000000E1
10011111011000110000100001
1001C00001C1C1C10001010001
10011111010010010010N01001
1001C0000100N001C1111111C1
1001111111000001100000C011
1C000000000C0000000N000001
11111111111111111111111111